24
3330333333330333
0030000000000300
3030000000000300
3033333003333300
3000000003000000
3333333303000000
0000000003000330
0003333333003330
3000000000003000
3000000000033000
3333333303330003
0000000303000003
0000000303000033
0000000303000033
0000000303000030
0000000303000330
0000000343000330
0000000333000300
0000000000000300
0000000000000300
0003330000000300
0000030000000300
0004444444444400
0000000000000000
