80
3330333333330333
2030333333330300
3030000000000300
3033333303333300
3000000003330000
3333333303330000
0000000003300330
0003333333003000
3000000000003000
3000000000033000
3333333303330003
0000000303000003
0000000303000033
0000000303000033
0000000303000030
0000000303000330
3003000343000330
3003000333003300
3003000000000300
3003000000000300
3033330000000300
3030033300000300
3034444444444300
3033333333333333
3030000030300033
3023030003000003
3030003030003003
3000030003030303
3330300030003003
3303030300030303
3030000000300003
3303030303000303
3030303030303033
3000000000000003
3000000000000003
3003030303030303
3000000000000003
3033333333333333
3100000000000003
3333333333333303
3000000000000003
3033333333333333
3000000000000003
3333333333333303
3000000000000003
3033333333333333
3000000000000003
3333333333333303
3000000000000003
3033333333333333
3000000000000003
3333333333333303
0000000000000003
0040300033333333
0300300000000000
0000000400000040
0400000000300000
0000330000300400
0000040000303300
0400000000000000
0000000400040000
0030000000400000
0000030033000000
0040000000000000
0000000000000000
0000000000000000
0000000000000000
0000000000000000
3333333333333333
0000000000000000
0030300000000000
0030300000000000
0003003330303000
0003003030303000
0003003330333000
0000000000000000
0030303030000000
0030303000333000
0003030030303000
0003030030303000
