41
3033300000303030
0033003000033300
0333333003333300
0333033000333300
3033333003333330
0303333003330303
3333333000033330
3333303330000030
3333333333333333
3333333333300333
3033333333303030
3030333333303030
3030303033303030
3030303030303030
3030300000303030
3030303030303030
0000000000000000
0000030300000000
0033300330000000
0003340333330000
0000333000033330
0000333340000033
0233033333333333
0003323333300033
0030333330000003
0000333333033000
3033333333333330
3333330330333303
3033330003000333
0300003333000333
0033300330003333
0000033000330003
0000000330000333
0003300000000300
3003300000000300
3333300000000000
0003333300000000
0003300300000000
0003300300033330
0000333000000330
0000000000000030
