41
3033311033303030
0033013033333300
0333313033333300
0333010033333300
3033330333333330
0303331303330303
3333331333333330
3333301330303030
3333333333333333
3333333033333333
3033303030303030
3030303030303030
3030303030303030
3030303030303030
3030303030303030
3030303330303030
0000000000000000
0000000300000000
0000000330000000
0000000033330000
0000000000033330
0000000000000033
0000000000333333
0000003333300000
0000033000000000
0000000000000000
0000000000000000
0330000000000000
0033000000000000
0000000000000000
0000000000000000
0000000000000003
0000000000000333
0003300000000300
3003300000000300
3333300000000000
0003333300000000
0003300300000000
0003300300033330
0000333000000330
0000000000000030
