16
3030303030303030
0303030303030303
3030303030303030
0303030303030303
3030303030303030
0303030303030303
3030303030303030
3030303030303030
3333333033333333
3333333033333333
3030303030303030
3030303030303030
3030303030303030
3030303030303030
3030303030303030
3030303030303030
