29
3330333333330333
2030000000000300
3030000000000300
3033333003333300
3000000003000000
3333333303000000
0000000003000330
0003333333003330
3000000000003000
3000000000033000
3333333303330003
0000000303000003
0000000303000033
0000000303000033
0000000303000030
0000000303000330
3003000343000330
3003000333000300
3003000000000300
3003000000000300
3033330000000300
3030033300000300
3034444444444300
3033333333333300
3030003000300000
3030003000300000
3000300030003000
3000300030003000
3333333333333300
